10 10
2 4
XXXXXXXXXX
XX...XX..X
XX..XXX.XX
XX.......X
XXXXXXX.XX
X....XX.XX
X.XX....X
X...XXXXXX
XXX..t.XXX
XXXXXXXXXX
